# 计算机专业英汉词汇对照表
API = 应用程序接口
algorithm = 算法
artificial intelligence = 人工智能
bandwidth = 带宽
binary = 二进制
bit = 比特
browser = 浏览器
buffer = 缓冲区
bug = 程序错误
byte = 字节
cache = 缓存
client = 客户端
cloud computing = 云计算
compiler = 编译器
data mining = 数据挖掘
database = 数据库
debugging = 调试
desktop = 桌面
distributed system = 分布式系统
encryption = 加密
firewall = 防火墙
framework = 框架
frontend = 前端
backend = 后端
gateway = 网关
hardware = 硬件
hash = 哈希
hyperlink = 超链接
IDE = 集成开发环境
interface = 接口
interpreter = 解释器
kernel = 内核
localhost = 本地主机
machine learning = 机器学习
memory = 内存
network = 网络
object-oriented = 面向对象
packet = 数据包
programming language = 编程语言
protocol = 协议
query = 查询
recursion = 递归
router = 路由器
runtime = 运行时
scalability = 可扩展性
server = 服务器
software = 软件
source code = 源代码
stack = 堆栈
syntax = 语法
thread = 线程
virtual machine = 虚拟机
virus = 病毒
web = 网络
XML = 可扩展标记语言 