# 操作系统专业英汉词汇对照表
address space = 地址空间
batch processing = 批处理
boot = 引导，启动
bootloader = 引导加载程序
command line interface = 命令行界面
context switch = 上下文切换
CPU scheduling = CPU调度
daemon = 守护进程
deadlock = 死锁
device driver = 设备驱动程序
disk fragmentation = 磁盘碎片
distributed operating system = 分布式操作系统
file system = 文件系统
interrupt = 中断
I/O = 输入/输出
kernel mode = 内核模式
memory leak = 内存泄漏
memory management = 内存管理
microkernel = 微内核
monolithic kernel = 宏内核
multitasking = 多任务处理
mutex = 互斥锁
paging = 分页
pipe = 管道
preemptive scheduling = 抢占式调度
privilege level = 特权级
process = 进程
process control block = 进程控制块
protection ring = 保护环
race condition = 竞态条件
real-time operating system = 实时操作系统
registry = 注册表
scheduler = 调度器
semaphore = 信号量
shell = 外壳，命令解释器
spooling = 假脱机
swap space = 交换空间
system call = 系统调用
task manager = 任务管理器
thread = 线程
throughput = 吞吐量
time sharing = 分时
user mode = 用户模式
virtual memory = 虚拟内存
zombie process = 僵尸进程 